R 900 400
NO ./textures/brick.xpm
SO ./textures/blue.xpm
WE ./textures/grey.xpm
EA ./textures/wood.xpm

S ./sprites/barrel.xpm

F 224,172,105
C 205,249,255

111111111111111
 110001000000011
  11000000000001
111000S000001111
1000000000001
1000000000001
1111111111111